###############
#...#.........#
#...#...###...#
#...#####..C..#
#.C.....#.....#
#...#.####....#
#...#......#..#
#...#..C..##..#
#...#......#..#
#.C....#......#
#...#####.....#
#.......#.....#
#.......####..#
#.............#
###############