###############
#...#.........#
#...#...###...#
#...#####.....#
#.......#.....#
#...#.####....#
#...#......#..#
#...#.....##..#
#...#......#..#
#......#......#
#...#####.....#
#.......#.....#
#.......####..#
#.............#
###############